########################################################################################################################
#                                                                                                                      #
#                                                                                                                      #
#                                                                                                                      #
#                                                                                                                      #
#                                                                                                                      #
#                                                                                                                      #
#                                                                                                                      #
#                                                                                                                      #
#                                                                                                                      #
#  [>                                                                                                                  #
#  |                                                                                                                   #
#  |                                                                                                                   #
#  |                                                                                               [[[[[[[[[[[[[       #
#[[[[[[[[[[[[[[[[[[            [[[[[[[[[[[[[[[[[[[                                          [[[[[[[[                   #
#                 [[[[[[[[[[[[[[       $$$$      [[[[[[[[[[[[[[[                 [[[[[[[[[[[[                          #
#                                    ~~~~~~~~                  [[[[[[XXXXXX[[[[[[[                                [[[[[#
#                                 $$                                                                           [[[[    #
#                            ~~~~~~~~~~             $$                                                      [[[[       #
#                                             [[[[[[[[[[                                                 [[[[          #
#                    ~~~~~~~~~~~~~~                                                                [[[[[[[             #
#                                                             $$                                                       #
#      ~~~~~~~~~~   $                                        [[                            [[[[                        #
#                                                            [[                         [[[[                           #
#         $         X[[      $                              X[[                      [[[[                              #
#[[[[[[[[[[[[[[[[[[[[[[[[[[[[[[[[[[[[[[[[[[[[[[[[[[[[[[[[[[[[[[[[[[[[[[[[[[[[[[[[[[[[[[[[[[[[[[[[[[[[[[[[[[[[[[[[[[[[[[#
########################################################################################################################