########################################################################################################################
#                                                                                                                      #
#                                                                                                                      #
#                                                                                                                      #
#                                                                                                                      #
#                                                                                                                      #
#                                                                                                                      #
#                                                                                                                      #
#                                                                                                                      #
#                                                                                                                      #
#  [>                                                                                                                  #
#  |                                                                                                                   #
#  |                                                                                                                   #
#  |                                                                                                                   #
#                                                                                                                      #
#                                                                                                                      #
#                                                                                                                      #
#                                                                                                                      #
#                                                                                                                      #
#                                                                                                                      #
#                                                                                                                      #
#                                                                                                                      #
#                                                                                                                      #
#                                                                                                                      #
#                                                                                                                      #
#[[[[[[[[[[[[[[[[[[[[[[[[[[[[[[[[[[[[[[[[[[[[[[[[[[[[[[[[[[[[[[[[[[[[[[[[[[[[[[[[[[[[[[[[[[[[[[[[[[[[[[[[[[[[[[[[[[[[[[#
########################################################################################################################